111111
100101
101001
1000E1
1C0011
111111
